XXXXXXXXXXXXXXXXXXXXXXXXXXX
XSOOXOOOOOOOOOOOOOXOOOOOOOX
XOXOXXXOXXXXXXXOXXXOXXXXXOX
XOXOOOOOXOOOXOOOXOOOXOOOOOX
XOXXXXXXXOXOXXXXXOXXXOXXXXX
XOXOOOOOOOXOXOOOOOXOXOXOOOX
XOXOXXXXXXXOXOXXXXXOXOXOXOX
XOOOXOOOOOXOXOXOOOOOXOOOXOX
XOXXXOXXXOXOXOXOXOXOXXXXXOX
XOOOXOXOOOXOXOXOXOXOOOXOOOX
XXXOXXXOXXXOXOXXXOXXXOXOXXX
XOXOOOXOXOOOXOOOXOXOOOXOOOX
XOXXXOXOXOXOXXXOXOXOXXXXXOX
XOOOXOOOXOXOOOXOOOXOXOOOXOX
XOXOXXXOXOXXXOXOXXXXXOXOXOX
XOXOOOOOXOXOOOXOXOOOXOXOXOX
XOXXXXXXXOXXXXXOXOXOXOXOXOX
XOXOOOXOXOOOOOOOXOXOOOXOXOX
XOXOXOXOXXXXXXXXXOXXXXXOXOX
XOXOXOOOOOOOXOOOOOXOOOXOXOX
XOXOXOXXXXXXXOXXXXXOXXXOXOX
XOOOXOXOOOOOXOXOOOXOOOOOXOX
XXXXXOXOXXXXXOXOXXXOXXXXXOX
XOOOXOXOOOOOOOXOXOOOXOOOXOX
XOXXXOXXXXXXXXXOXOXXXOXOXOX
XOOOOOOOOOOOOOOOXOOOOOXOOEX
XXXXXXXXXXXXXXXXXXXXXXXXXXX