XXXXXXXXXXXXXXXXXXXXXXXXXXX
XSOOXOOOOOOOOOOOOOXOOOOOOOX
XOXOXXXOXXXXXXXOXXXOXXXXXOX
XOXOOOOOXOOOXGOOXOOOXOOOOOX
XOXXXXXXXOXOXXXXXOXXXOXXXXX
XOXOOOOOOOXOXOOOOOXOXOXOOOX
XOXOXXXXXXXOXOXXXXXOXOXOXOX
XOOOXOOOOOXOXOXOOOOOXOOOXOX
XOXXXOXXXOXOXOXOXOXOXXXXXOX
XOOOXOXOOOXOXOXOXOXOOOXOOOX
XXXOXXXOXXXOXOXXXOXXXOXOXXX
XOXOOOXOXOOOXOOOXOXOOOXOOOX
XOXXXOXOXOXOXXXOXOXOXXXXXOX
XOOOXOOOXOXOOOXOOOXTXOOOXOX
XOXOXXXOXOXXXOXOXXXXXOXOXOX
XOXOOOOOXOXOOOXOXOOOXOXOXOX
XOXXXXXXXOXXXXXOXOXOXOXOXOX
XOXOOOXOXOOOOOOOXOXOOOXOXOX
XOXOXOXOXXXXXXXXXOXXXXXOXOX
XOXOXOOOOOOOXROOOOXOOOXOXOX
XOXOXOXXXXXXXOXXXXXOXXXOXOX
XOOOXOXOOOOOXOXOOLXOOOOOXOX
XXXXXOXOXXXXXOXOXXXOXXXXXOX
XOOOXOXOOOOOOOXOXOOOXOOOXOX
XOXXXOXXXXXXXXXOXOXXXOXOXOX
XOOOOOOOOOOOOOOOXOOOOOXOOEX
XXXXXXXXXXXXXXXXXXXXXXXXXXX